19
1111111111111111111
1010000010001000001
1010111110111111101
1000000010000010101
1110111110111110101
1000001013001010001
1110111010111011101
1000000010100000001
1010111110111010101
1010100000001010101
1110101110111110111
1012001010000000001
1010101011111111101
1010101000100000001
1011101110101110111
1000101000100010001
1011101110101111101
1000000010000010001
1111111111111111111
